11111111111111
111111PEC11111
1111111111111
