1111111111111
1C010000000C1
1000011111001
1P0011E0000C1
1000000000001
1111111111111
