1111111111111
1C000000000C1
1110011111001
1P0011CEB00C1
1111111111111
